###############
#.............#
#.##.##.##.##.#
#.#.........#.#
#...#.#.#.#...#
#.###.#.#.###.#
#.....#.#.....#
####.##.##.####
#.....#.#.....#
#.###.#.#.###.#
#...#.#.#.#...#
#.#.........#.#
#.##.##.##.##.#
#............@#
###############